R 1920 1080
S ./text/barrel.xpm
NO ./text/redbrick_N.xpm     
WE ./text/greystone_w.xpm
SO ./text/mushroom.xpm
EA ./text/eagle_E.xpm

F 120,30,000
C  020,0,255   


111111111111111
120200020000011
1210000W0000001
120000000000001
100000000000001
111111000111111
100000100000001
111111000111011
111111000111111
100000010000001
111111010111111
1000000000000011
12000000000021101
11111111111111111
